OOOOXXXOOO
OOOXXXXXOO
OXXXXXXXXO
XXXXXXXXXX
XXXXXXXXXX
XXXXXXXXXX
XXXXXXXXXX
OXXXXXXXXX
OOXXXXXXXO
OOOXXXXOOO
OOOOXXOOOO
